15
15
AAAAAAAAAAAAAAA
AAAAAAAAAAAAAAA
AAAAAAAAAAAAAAA
AAAAAAAAAAAAAAA
XXXVYHLVXNXXXXX
XFXVGMDVXXXXXXX
XXXVZBWVXXFXXXX
TTTTTTTTTTTTXXX
PPPPPPPPPPPPXXX
XXXXXXXXXXXXXXX
XXXXXXXXXXXXXXX
XXXXXXXXXXXXXXX
XXXXXXXXXXXXXXX
XXXXXXXXXXXXXXX
XXXXXXXXXXXXXXX
