10
15
AXXXXXXXXXXXXXX
XAXXXXXXXXXXXXX
XXAXXXXXXXXXXXX
XXAAXXXXXXXXXXX
XXAAAXXXXXXXXXX
XXXXXAXXXXXXXXX
XXXXXXAXXXXXXXX
XXXXXXXXXXXXXXX
XXXXXXXXXXXXXXX
XXXXXXXXXXXXXXX
