30
38
AAAAAAAAAAAAAAAAAAAAAAAAAAAAAAAAAAAAAA
AAAAAAAAAAAAAAAAAAAAAAAAAAAAAAAAAAAAAA
AAAAAAAAAAAAAAAAAAAAAAAAAAAAAAAAAAAAAA
AAAAAAAAAAAAAAAAAAAAAAAAAAAAAAAAAAAAAA
AAAAXXXVYHLVXNXXXXXXXXVYHLVXNXXXXXAAAA
AAAAXFXVGMDVXXXXXXXXFXVGMDVXXXXXXXAAAA
AAAAXXXVZBWVXXFXXXXXXXVZBWVXXFXXXXAAAA
AAAATTTTTTTTTTTTXXXTTTTTTTTTTTTXXXAAAA
AAAAPPPPPPPPPPPPXXXPPPPPPPPPPPPXXXAAAA
AAAAXXXXXXXXXXXXXXXXXXXXXXXXXXXXXXAAAA
AAAAXXXXXXXXXXXXXXXXXXXXXXXXXXXXXXAAAA
AAAAXXXXXXXXXXXXXXXXXXXXXXXXXXXXXXAAAA
AAAAXXXXXXXXXXXXXXXXXXXXXXXXXXXXXXAAAA
AAAAXXXXXXXXXXXXXXXXXXXXXXXXXXXXXXAAAA
AAAAXXXXXXXXXXXXXXXXXXXXXXXXXXXXXXAAAA
AAAAXXXXXXXXXXXXXXXXXXXXXXXXXXXXXXAAAA
AAAAXXXXXXXXXXXXXXXXXXXXXXXXXXXXXXAAAA
AAAAXXXXXXXXXXXXXXXXXXXXXXXXXXXXXXAAAA
AAAAXXXXXXXXXXXXXXXXXXXXXXXXXXXXXXAAAA
AAAAXXXVYHLVXNXXXXXXXXVYHLVXNXXXXXAAAA
AAAAXFXVGMDVXXXXXXXXFXVGMDVXXXXXXXAAAA
AAAAXXXVZBWVXXFXXXXXXXVZBWVXXFXXXXAAAA
AAAATTTTTTTTTTTTXXXTTTTTTTTTTTTXXXAAAA
AAAAPPPPPPPPPPPPXXXPPPPPPPPPPPPXXXAAAA
AAAAXXXXXXXXXXXXXXXXXXXXXXXXXXXXXXAAAA
AAAAXXXXXXXXXXXXXXXXXXXXXXXXXXXXXXAAAA
AAAAXXXXXXXXXXXXXXXXXXXXXXXXXXXXXXAAAA
AAAAXXXXXXXXXXXXXXXXXXXXXXXXXXXXXXAAAA
AAAAXXXXXXXXXXXXXXXXXXXXXXXXXXXXXXAAAA
AAAAXXXXXXXXXXXXXXXXXXXXXXXXXXXXXXAAAA
